@
###########
.
.###########
.
###########
.
####....####
####....####
##........##