################
...............#
.####....#######.
..###..####...#.
#..##.@.##...###
.....##..
###.#..#..######
###..##..#######
####....########
#####.##########
.