...###
..##.#.####
.##..###..#
.#........#
....@..#..#
.##..###..#
..#..#....#
.##.##.#.##
.#......##
.#.....##
.#######x